5 8
4 1
2 7
********
*.*.****
*...*...
*.*...**
*.******
